128 11
1 2 3 4 5 6 1 2 1 2 3 4 5 6 1 2 1 2 3 4 7 8 1 2 1 2 3 4 5 6 1 2 9 10 3 4 5 6 9 10 1 54 1 54 1 54 1 54 3 4 5 6 11 11 3 4 12 13 1 54 1 54 9 10 3 4 9 10 3 4 9 10 3 4 9 10 3 4 1 54 9 10 1 54 12 13 12 13 1 54 11 11 3 4 14 75 0 16 16 16 16 16 3 4 16 16 16 16 16 16 16 16 17 18 16 16 17 18 16 16 16 16 16 16 16 16 25 25
26 27 3 4 28 29 30 31 32 33 3 4 28 29 30 31 32 33 3 4 7 8 30 31 32 33 3 4 28 29 30 31 26 27 3 4 28 29 11 11 32 33 32 33 32 33 32 33 3 4 35 36 11 11 3 4 32 33 32 33 32 33 26 27 3 4 11 11 3 4 11 11 3 4 11 11 3 4 32 33 11 11 32 33 32 33 32 33 32 33 11 11 3 4 16 69 0 16 16 39 16 16 3 4 16 16 40 16 40 16 40 16 3 4 16 39 3 4 16 16 16 16 40 16 40 16 16 69
12 13 3 4 48 49 9 10 1 2 3 4 48 49 9 10 1 2 3 4 5 6 9 10 1 2 3 4 48 49 9 10 12 13 3 4 48 49 11 11 1 54 51 54 1 54 1 54 3 4 50 51 11 11 3 4 1 2 1 2 1 2 12 13 3 4 11 11 3 4 11 11 3 4 11 11 3 4 1 54 11 11 1 54 1 54 1 54 1 54 11 11 3 4 16 76 0 16 52 53 16 16 17 18 16 16 16 16 16 16 16 16 17 18 52 53 3 4 16 16 16 16 16 16 16 16 16 76
32 33 3 4 35 61 11 11 32 33 3 4 28 60 11 11 32 33 3 4 28 29 11 11 32 33 3 4 28 60 11 11 32 33 3 4 28 29 11 11 32 33 32 33 54 55 56 57 58 59 60 24 62 62 62 62 63 64 65 66 32 33 32 33 3 4 11 11 3 4 11 11 3 4 11 11 3 4 30 31 11 11 32 33 54 55 56 57 62 62 60 61 58 59 16 86 0 16 16 16 16 16 58 59 16 16 16 16 67 68 67 68 3 4 67 68 3 4 16 16 16 39 16 16 16 16 16 86
1 2 3 4 50 49 11 11 1 2 3 4 48 49 11 11 1 2 3 4 48 49 11 11 1 2 3 4 48 49 11 11 1 2 3 4 48 1 11 11 70 54 1 54 1 56 71 25 25 25 25 25 25 25 25 25 25 72 73 74 1 2 1 2 3 4 11 11 3 4 11 11 3 4 11 11 3 4 9 10 11 11 1 54 1 56 71 25 25 25 25 25 25 25 25 25 25 25 25 25 25 25 25 25 16 16 16 16 38 75 38 75 3 4 38 75 3 4 16 16 52 53 25 25 25 25 25 25
32 33 3 4 32 33 11 11 32 33 3 4 35 33 11 11 30 31 3 4 28 60 11 11 32 33 3 4 35 33 11 11 32 33 3 4 28 29 11 11 54 55 56 57 77 71 78 79 3 4 32 33 26 27 3 4 80 81 72 73 60 2 62 62 3 4 11 11 3 4 11 11 3 4 11 11 3 4 26 27 11 11 32 33 56 71 78 79 32 33 32 33 3 4 47 75 0 16 67 68 67 68 41 42 16 16 62 97 16 16 67 68 0 0 0 0 25 25 16 16 62 97 16 16 16 39 98 75
1 2 3 4 1 2 11 11 1 2 3 4 50 2 11 11 9 10 3 4 48 2 11 11 1 2 3 4 50 2 11 11 1 2 3 4 48 49 11 11 70 56 71 25 25 25 87 88 3 4 1 2 12 13 3 4 2 20 25 25 25 25 25 25 3 4 11 11 3 4 11 11 3 4 11 11 3 4 12 13 11 11 1 56 71 89 60 88 1 54 1 54 3 4 14 75 0 16 38 75 38 75 3 4 25 25 25 99 97 16 38 75 0 0 0 0 41 42 25 25 25 99 97 16 52 53 98 75
32 33 3 4 32 33 11 11 30 31 3 4 32 33 11 11 26 27 3 4 35 33 11 11 32 33 3 4 32 33 11 11 26 27 3 4 35 33 54 55 56 71 78 79 30 31 32 33 3 4 32 33 32 33 3 4 32 33 3 4 30 31 30 31 3 4 11 11 3 4 11 11 3 4 11 11 3 4 30 31 54 55 56 71 78 79 30 31 32 33 32 33 3 4 47 75 0 16 16 16 16 16 3 4 67 68 3 4 99 97 16 16 0 0 0 0 3 4 67 68 3 4 99 97 16 16 98 75
1 2 3 4 1 2 11 11 9 10 3 4 1 2 11 11 12 13 3 4 50 2 11 11 1 2 3 4 1 2 11 11 12 13 3 4 50 2 70 56 71 89 60 88 9 10 1 2 3 4 1 2 1 2 3 4 1 2 3 4 9 10 9 10 3 4 11 11 3 4 11 11 3 4 11 11 3 4 9 10 1 56 71 89 60 88 9 10 1 54 1 54 3 4 14 75 0 16 16 16 16 16 17 18 38 75 3 4 93 99 97 16 0 0 0 0 3 4 38 75 3 4 93 99 97 16 98 75
60 61 58 59 60 61 60 61 60 61 58 59 60 61 60 61 60 61 58 59 60 61 60 61 60 61 58 59 60 61 60 61 60 61 58 59 60 61 56 71 60 2 60 2 60 2 60 2 58 59 60 2 60 2 58 59 60 2 58 59 60 2 60 2 58 59 60 61 58 59 60 61 58 59 60 61 58 59 60 61 77 71 60 61 60 61 60 61 60 61 60 61 58 59 95 75 0 16 62 97 16 16 58 59 16 16 58 59 16 93 99 97 0 0 0 0 58 59 62 97 58 59 16 93 99 97 98 75
25 25 25 25 25 25 25 25 25 25 25 25 25 25 25 25 25 25 25 25 25 25 25 25 25 25 25 25 25 25 25 25 25 25 25 25 25 25 25 25 25 25 25 25 25 25 25 25 25 25 25 25 25 25 25 25 25 25 25 25 25 25 25 25 25 25 25 25 25 25 25 25 25 25 25 25 25 25 25 25 25 25 25 25 25 25 25 25 25 25 25 25 25 25 25 25 25 25 25 90 25 25 25 25 25 25 25 25 25 25 25 25 0 0 0 0 25 25 25 90 25 25 25 25 25 25 25 25
